111111111111111111111111111
1P1EZC0000000000C0Z00000001
1C10100000001010Z0000000001
10101000000ZC10010000000001
10101000ZC0Z01C100000000001
1000000C0000001C10000000001
100000000000010000Z00000001
100000000000010000Z00000001
100000000000010000Z00000001
100000000000010000Z00000001
100000000000010000Z00000001
100000000000010000Z00000001
100000000000010000Z00000001
100000000000010000Z00000001
100000000000010000Z00000001
100000000000010000Z00000001
100000000000010000Z00000001
100000000000010000Z00000001
100000000000010000Z00000001
100000000000010000Z00000001
100000000000010000Z00000001
111111111111111111111111111