111111111111111111111111
1P1EZ0000000000000Z00001
1010100000001010Z00C0001
101C1000000ZC10010000001
10101000Z00Z01C100000001
100000000000001C10000001
100000000000010000Z00001
111111111111111111111111