1111111111
1C10010001
10C001C001
1110010111
10P00000Z1
1111Z0Z111
10CC00C101
1101111111
1E000000C1
1111111111
