111111111111111111111111
1P1EZC0000000000C0Z00001
1C10100000001010Z0000001
10101000000ZC10010000001
10101000ZC0Z01C100000001
1000000C0000001C10000001
100000000000010000Z000C1
111111111111111111111111