111111111111111111111111
1P1EZ0000000000000000001
1010100000001C1000000001
101C10000000010010000001
1010100000000101C0000001
1000000000000C1010000001
100000000000010000000001
111111111111111111111111