111111111111111111111111
1P1EZ0000000000000000001
101010000000101000000001
101C10000000010010000001
101010000000010100000001
100000000000001010000001
100000000000010000000001
111111111111111111111111