11111111111
1C11E000001
1001100Z001
100C1000001
1000100P001
1000C000001
11111111111