1111111111
1P1C01C001
1000101001
10000000E1
1111111111