111111111111111111111111
1P1EZ0000000000000Z00001
1C10100000001010Z0000001
10101000000Z010010000001
10101000Z00Z010100000001
100000000000001010000001
100000000000010000Z00001
111111111111111111111111